######################################################
#....................................................#
#....................................................#
#....................................................#
#....................................................#
#....................................................#
#....................................................#
#"..........#.....###................................#
##.......#####............."...""""".................#
######"""#############################################
