######################################################
#.....###............................................#
#......p.............................................#
#.....###............................................#
#....................................................#
#....................................................#
#....................................................#
#"..........#.....###................................#
##.......#####............."...""""".................#
######"""#############################################
