######################################################
#....................................................#
#....................................................#
#....................................................#
#....................................................#
#....................................................#
#p......................#......................x.....#
#".................#..###............................#
##"...............###...l............................#
#"#"#"#"#"#"#"#"#"#"#"#"#"#"#"#"#"#"#"#"#"#"#"#"#"#"##
