######################################################
#....................................................#
#....................................................#
#....................................................#
#....................................................#
#....................................................#
#p.............................................x.....#
#"...................................................#
##"..................................................#
#"#"#"#"#"#"#"#"#"#"#"#"#"#"#"#"#"#"#"#"#"#"#"#"#"#"##
